 13 31
###############################
#p#     #   *1#**   #     #   #
# # # # # # # # # # # # # # # #
#  x#   * #     # * * # 1     #
# # # # # # # # # # # # # # #*#
#f    #     # * * #   1 #     #
# # # # # # * # # # # # # # # #
# # *   #   * #     #     #   #
# # # # #*# # # # # # # # # # #
#*  *     # * * # *   *   1 # #
# # # # * # # #*# # # # # # # #
#     #     # 1 * #*    #   * #
###############################