2 13 31
###############################
#p * *1 3   3 *  ** * *      *#
#   # # #*# # #*# # # # # #*# #
#     * * *** **      *    ** #
# #*# # # # #1# #b#1# # # # #*#
#2    3     *     **      * **#
# # #*# # # # # #*#*#*#*# # # #
#   *        *   * * * *      #
# # # # #*# # # # # # #*# #*# #
#   ****         *1           #
#x# # # # # # # # #*# # # # #*#
#  ** *   *                   #
###############################